{
    "gems": [
         8,  8,  8,  0,  8,  8,  8,
         7,  7,  7,  0,  7,  7,  7,
        61, 40, 40,  8, 40, 40,  4,
        11, 60, 60,  7, 10, 10, 62,
        40, 40, 60, 20, 10, 20, 40,
         0, 20,  0, 10,  0, 60,  0,
        40, 60, 60, 20, 42, 40, 10,
        10, 20, 12,  0, 21, 40, 10,
        10, 60, 63,  0, 60, 60, 20
    ],
    "tiles": [
         0,  0,  0,  0,  0,  0,  0,
         0,  0,  0,  0,  0,  0,  0,
         1,  1,  1,  2,  1,  1,  1,
         1,  1,  1,  2,  1,  1,  1,
         1,  1,  1,  1,  1,  1,  1,
         2,  1,  2,  1,  2,  1,  2,
         1,  1,  1,  1,  1,  1,  1,
         1,  1,  1,  2,  1,  1,  1,
         1,  1,  1,  2,  1,  1,  1
    ],
    "gravities": [
         2,  2,  2,  0,  2,  2,  2,
         2,  2,  2,  0,  2,  2,  2,
         2,  2,  2,  2,  2,  2,  2,
         2,  2,  2,  2,  2,  2,  2,
         2,  2,  2,  2,  2,  2,  2,
         0,  2,  0,  2,  0,  2,  0,
         2,  2,  2,  2,  2,  2,  2,
         2,  2,  2,  0,  2,  2,  2,
         2,  2,  2,  0,  2,  2,  2
    ],
    "cols": 7,
    "rows": 9,
    "moves": 18
}