{
    "gems": [ 
         8,  8,  0,  0,  0,  8,  8,
         7,  7,  8,  0,  8,  7,  7,
        10, 10,  7,  8,  7, 10, 10,
        30, 30, 40,  7, 40, 30, 30,
         0, 60, 60, 10, 60, 60,  0,
         0, 10, 10, 40, 10, 10,  0,
         0, 40, 60, 10, 60, 40,  0,
        10, 30, 10, 30, 10, 30, 10,
        10, 30, 10, 30, 10, 30, 10
    ],
    "tiles": [ 
         0,  0,  0,  0,  0,  0,  0,
         0,  0,  0,  0,  0,  0,  0,
         1,  1,  0,  0,  0,  1,  1,
         1,  1,  1,  0,  1,  1,  1,
         0,  1,  1,  1,  1,  1,  0,
         0,  1,  1,  1,  1,  1,  0,
         0,  1,  1,  1,  1,  1,  0,
         1,  1,  1,  1,  1,  1,  1,
         1,  1,  1,  1,  1,  1,  1
    ],
    "cols": 7,
    "rows": 9,
    "gravity": [0, -1],
    "moves": 10
}