{
    "tiles": [ 
        0, 8, 8, 8, 0,
        0, 7, 7, 7, 0,
        0, 1, 1, 1, 0,
        0, 1, 1, 1, 0,
        0, 1, 1, 1, 0,
        1, 1, 1, 1, 1,
        1, 1, 1, 1, 1,
        1, 1, 1, 1, 1,
        1, 1, 1, 1, 1
    ],
    "cols": 5,
    "rows": 9,
    "gravity": [0, 1],
    "moves": 10
}