{
    "tiles": [ 
         8,  8,  8,  8,  8,  8,  8,  8,  8,
         7,  7,  7,  7,  7,  7,  7,  7,  7,
        20, 20, 30, 60, 20, 60, 30, 20, 20,
        60, 60, 10, 30, 20, 30, 10, 60, 60,
        10, 10, 20, 10, 60, 10, 20, 10, 10,
        60, 20, 20, 30, 60, 30, 20, 20, 60,
        10, 10, 60, 10, 20, 10, 60, 10, 10,
         0, 20, 10, 60, 30, 60, 10, 30,  0,
         0,  0, 30, 20, 30, 20, 30,  0,  0
    ],
    "cols": 9,
    "rows": 9,
    "gravity": [0, -1],
    "moves": 15
}