{
    "gems": [
         8,  8,  8,  8,  8,  8,  8,  
         7,  7,  7,  7,  7,  7,  7,
        50, 30, 40, 10, 50, 30, 10,
        40, 10, 10, 40, 10, 10, 40,
        30, 30, 50, 10, 50, 30, 30,
        50, 50, 30, 50, 30, 50, 50,
        40, 10, 50, 40, 50, 10, 40,
        10, 30, 10, 30, 10, 30, 10,
        10, 10, 40, 30, 40, 10, 10
    ],
    "tiles": [
         0,  0,  0,  0,  0,  0,  0,  
         0,  0,  0,  0,  0,  0,  0,
         1,  1,  1,  1,  1,  1,  1,
         1,  1,  1,  1,  1,  1,  1,
         1,  1,  1,  1,  1,  1,  1,
         1,  1,  1,  1,  1,  1,  1,
         1,  1,  1,  1,  1,  1,  1,
         1,  1,  1,  1,  1,  1,  1,
         1,  1,  1,  1,  1,  1,  1
    ],
    "gravities": [
         2,  2,  2,  2,  2,  2,  2,  
         2,  2,  2,  2,  2,  2,  2,
         2,  2,  2,  2,  2,  2,  2,
         2,  2,  2,  2,  2,  2,  2,
         2,  2,  2,  2,  2,  2,  2,
         2,  2,  2,  2,  2,  2,  2,
         2,  2,  2,  2,  2,  2,  2,
         2,  2,  2,  2,  2,  2,  2,
         2,  2,  2,  2,  2,  2,  2
    ],
    "missions": [
        {"gemID": 50, "howMany": 25},
        {"gemID": 10, "howMany": 30}
    ],
    "availableGemTypes": [
        10, 30, 40, 50
    ],
    "cols": 7,
    "rows": 9,
    "moves": 18
}