{
    "tiles": [ 
        0, 0, 0, 8, 8, 8, 0, 0, 0,
        0, 0, 0, 7, 7, 7, 0, 0, 0,
        0, 0, 0, 1, 1, 1, 0, 0, 0,
        0, 0, 1, 1, 1, 1, 1, 0, 0,
        0, 1, 1, 1, 1, 1, 1, 1, 0,
        1, 1, 1, 1, 1, 1, 1, 1, 1,
        1, 1, 1, 1, 1, 1, 1, 1, 1,
        0, 4, 1, 1, 1, 1, 1, 4, 0,
        0, 0, 1, 4, 4, 4, 1, 0, 0,
        0, 0, 0, 4, 4, 4, 0, 0, 0
    ],
    "cols": 9,
    "rows": 10,
    "gravity": [0, 1],
    "moves": 18
}