{
    "tiles": [ 
        0, 0, 0, 8, 8, 8, 0, 0, 0,
        0, 0, 0, 7, 7, 7, 0, 0, 0,
        0, 0, 0,10,50,30, 0, 0, 0,
        0, 0,30,30,20,10,10, 0, 0,
        0,50,30,10,50,30,10,50, 0,
       50,20,50,30,20,10,50,20,50,
       50,50,20,10,30,20,30,50,50,
        0, 4,10,50,30,50,20, 4, 0,
        0, 0,10, 4, 4, 4,20, 0, 0,
        0, 0, 0, 4, 4, 4, 0, 0, 0
    ],
    "colBoundary": [0, 8],
    "rowBoundary":[0, 7],
    "cols": 9,
    "rows": 10,
    "gravity": [0, -1],
    "moves": 18
}